
F108,2,119
R 1000 1000
C	 255,0,0

S			./textures/pillar.xpm
SO			./textures/mossy.xpm
NO			./textures/eagle.xpm
WE			./textures/redbrick.xpm
EA			./textures/wood.xpm


    1     1111
1111111111111111
1E00000000010001
10000001110001021
1000001  1111001
12011111111110111
1000000000000001 
1010101001010101
1201111001111111
11111110011111111
1200000000000021
1100000000000011
1200000000000021
1100000000000011
1200000000000021
1121212002121211
1111111001111111
1100000000000011
1111111001111111
1111111001111111
1111111001111111
1111111001111111
1111111001111111
1111111001111111
1111111001111111
1111111001111111
1111111001111111
1111111001111111
1111111001111111
1111111001111111
1111111001111111
1111111001111111
1111111111111111