
F108,2,119
R 1000 1000
C	 255,0,0

S			./textures/pillar.xpm
SO			./textures/mossy.xpm
NO			./textures/eagle.xpm
WE			./textures/redbrick.xpm
EA			./textures/wood.xpm


   1     1111
1111111111111111
10E0000000100011
10000001110001021
1000001  1111001
12011111111110111
1000000000000001 
1010101001010101
1111111111111111